6
G 2
f 3
g 1
h 4
m 7
r 5
100 100
g m m m f m G h G f g h G g g G f m f h f r G g r f g f r m g r h G m r G m f m m f h G h h g g g g f r r h f h G m r f r f r r f r m G g h m m r f g G h G g f h r m m g r g f r G r r f h g G g f g G 
G f f f r m h r h r g G h g f f h G m f m m m f h m r G m r g h m m g f m h m m r f f g m G g m G r r g G m m m G g h f g G g g m g f g h m r r m h g m f r G G g G m h f f g m h m f m r m m g r f f G 
m m G h G f g m h G G f h r g r G g G f G h g h h m g h g G G m g g r h m h G r g f m m g m r f m f r h r h m r G G f G m f h m m G g r f f g G f h r r G G g G G f h g r G r r G g h r g h m G g h m r 
g f h r f G g G G G r r g f m m r h G h h m f G r h G g g h m h r G f m m G f m G r r h m m G g m h G G g G m g m g g r f m m r g r r f G m r g f g m G r h r r g G g m g m g G h r h G h h G G g r m g 
G f h f h h f m G g m g m h m h h h G h h g G G G G m h f G r r G g f r m f g m h G g g h m g g m r h h r m g r g g G m f G f r G h f r h m f m m G r g m m h h m m g f f G f m m G r f r g m m h f G f 
m r g r g G h g m g h h h h G r g h m h g h r f r f G h m r g f m r f m m h h r h m g r f f r f f r g h g G r g G f g g r G r h h h r f m h h f r f r f r f r f g G m f G G m G m m h m G g g r m r g m 
G m f h h m m g g m f h r f m h g G f g m f f f m h g r f g G G G r h m g r h h r f r g h g f h f G f G m f f m f g g f f f r h h h G f g h h f r f G f G m f h r f G g h r r g h g f m m m r g g G G g 
m G m m m f f m f f f m m g G G r h m G f h G r f h r m g m r G m g g h f m r h m f G r h h f m g r g h f r f h h f G G g f r r f g h h g r g G g f m m h h h h r r h m m G g h h f G g g h f g m g g f 
h g h m r m r r m f f f g f m g g h g m g g h f g f m h h h G G g h f G g r g h h g G r m m h f r G f f G G r f g r h m h g h h G h h g r m m G r f r h f G r G m g f h f h m h g m h r h g G r h h f g 
r h r h f m h G g G g r g f h g f g G m h g r h f f h m g f h g h m r h f r f m r m m m G G f r m f h f g m g r f h m G f h g g f h h m f h f f f f m r m m G g m f g h g g r h g r m h G g r r m h G r 
f f G G f m f G G h m G f h f h m m h g m f m g G G h r r f g G f f h f m r G m f g h r G g G h G r m G m m g h f r g f G m r h G h h h g f g G g r g G f r r h G g h f m G f m g h r f g h g r h m G r 
G h h G f h g m m m h r h G f G h m g f r r G f f r m g h g g f m G G m G g h f g h h h g G r m r g f f r h r g h r h m g g m r r G h m m g f f h G g h m f f f m h G h r g h G r f h h G r f g f r m r 
f g r G g g m f h f G h m r m h g m h G g m f G m g g m f h f f G m f g m m G G m h g r g m f h f f G G G g g f f m m m f f m g m m G G r f G f g G r h h m m g r r r m g f r h h f f r m h r h m r G h 
f r G g g G G r f g f r g G f m f m f f f G h m f f m f G g g r G r f G G g h m h g G r G r G G r f f r h h r h r r h h g m r G G f m h h f f g h m g g m h m G r g f g h h G m r r m m r G m G f f r h 
g h r r m r h f f f r g G g f r G m f r m r G h r m m m r r G h r h G r h m f h r f m g G r h g f G m h f r f r f m f m f f m r m m r r g r h m r h f g G m h G G h g m h f r f m G h f G r h G g m G G 
f m g h h G h G m m m h f r h G g h g G m m f r m f g r m f m h r h g m f h r f r g f g g f G f h h m f g G g h h r g r r h m r h f h g f m G g G r G G G f r r f g G r r g f g G m r G r f r g h g m h 
h r h f h G h g h m G f m f g m g G r m f m f r m f r m g h g h g h r m r f h f h r h f f m m g g f r G G G h f f G m g G h f g g r m g g r g h r h g h h h h G G G r m G f g G f h m m g m r f g m h h 
G m G f m g h r r f r G r f h G f g f f G f m m G r f f h h r G m m h r h f f h g r G h g g f f g m r m r g r r f G m g h r r G G f m G G f r f G G f g r G m f f m f G r G h h G h m r G h h m m G g G 
G f f f g g r m r G g m h h g h h G h m G r f r G G r r g G h g G m G G h m m G h G h G m G f G G h g r G G m g m m G G G g f r G m m r g r f m G f m f r f f f r G g m m f G G m f f r G m m m G f r G 
G h f f m G h r G m G m m m G h g f G m r f m G h m r G G h m m h g G g h m m g h f g r r G f r g f r m G G G g G h G h m f h G f f h r h g g G r h r G f g h r h m m h G f r m r f G r m h G m m G r g 
m G g m f m m G g r m f g g h h G m G G g h G r g G G g m G m g h G r h g g G f G f r h G m f h r f G m m f f h h r G g G m h h m G h f G m G m h r G m f h G f G r m h g G h h h h m m g r G m g m G r 
h r f r f m G h f h f r G m r g r h r m m h m h m r r m r f r h f f h r m h f f h G r r G G g f G r h f f m G m r m m h h f G G h m G f r m r g g G f h r r r r m f f f G r m h G g g r r h m r G G g G 
g g G m G h h h G f r g g g r f G m g h g m r f f f g g h f G G f g h g G G r g f r r h r h m g h h G G g G f g r f h m h G g h g m f g f m m G f r h h r g m m g f g m g f r G m f r G f f f r G h f h 
m r G f h r f m g m f m r f h r f h h h f G h r f g h m h h g r G G h m G g r h h G g f m r g g g f f f r r r h G g g g g G h f m g g G h G h h G g m m G G f G h G h G m r r G f r r f g g g G r G h G 
r h h f g G r g G g G g r r G m h G f G h G r G r h f g g f m f g r f f m f f g m r G G r g g G h r G f m g f m m g f f r m g g m g G G r m g r r G m h g G m m g m g m m r G r r r h m g m f g h g m m 
G f h r f g r g g g g f r G r h h G m m G m g h r f g m f r r f m f r G r f G m h r f h m m g m g G f G m h f r m h h r h g m g g g h h m r m m h G f r m G m g f G G m r r g r r m r f g G m h r m h f 
h r r r g G h g f g h m h h f f G G f G r f m r G g G g G g G h G h m h r r g m r m f g h f g r G g G G m g r m m g r g h G g f f h r m h g g g r G g h g f f h f h m G g r m G g h h g f r r G m G g g 
m G m m r m r r h h f g f r r G g g r G f r h f G g G r g m f r G m f m m r h g g g h r G r g h h G h m g r m r m f m G r f g G r g G f G G r h h G G G g G G h G G r r h g m m f r g h h m r h f G h m 
r m f G m G G r m g h G f G g g r f f h h g r r f h f r f h f h h m m r m G m r h G G m m f m g m f m r G h r f G m m r m g h g f G m r r f f G G r g G m f h f G r G m m m m f g g h h G G r h g h g m 
r m r m r g h g r r h m h h m r r g G r g m h r r m r r m h f r G m m m m G G f G g g r f m h r m f h f g m f f g G g g h f m m g m G f f f h h m f g r r m G g G f g h h g f g r G h h f G f G m r r f 
r h r G g m G r h m h m h g h f g m m g h G m G G g r m f m r h h f G m G m g h h m G f r m h f m g r r G h r h f h G f g h m g m f r g g g G h r h m g r m g r m f G h h f f r g r G G r h m f m f G m 
h h f h f g f f G G m r h g g g f m G g f h f r g r f g m G f g f h h h f f m r G h h G f f G G f G m m h g r f G h f G G G r m h h f m f r r h G f G h G g f r G G r r f h m r g G G r G G g g g G f h 
h m r r G f G f h r r G G g g g r h g r G r g m r g g f r G r m G h f G g h g f g m r G h G r m m G G G G g f G G f r r m f f g h m G G h G m h G r g m m h h m G G G f r r g r m G G f h m G r r h G G 
G f h G r h G m g h G m G r m G r r r G h G f r r m G m h g f G r r r h h f f g m h f h m f g G f m r r m m f h h h f g f r G G G g G G g r g G G h f m g f h f g r r r g m r m m h G f r G g h f h m g 
h m m f r f m G h g h h m g r G g f m g g r r m G g g m m h r G g g h G f h f f g r h r f h m h r m h g G r h G g G m m h g g h G m g m m h G h m h h g g G h r g G f m m f h f m m f G h h r G g g G G 
r G G m f f g G g m g h g m f r r G r h r m r r m h g G m h r f h G f g g h h G g g m r f h f h G r g m G G h h G f m g g r r h m r m f h h r f m G f h m h r r h h g g r g r h f h g m g m h m m m r r 
m f g m h m r f g h h r r f h f h h m f G h G g f G g r r g g G f r m G m m h g G G r m m m G G m h r f G m h h h h r f f G r m h g m h g r g g g f f r m f G m m g m h g f h g r g m f r h h m g G r r 
r h m G f r g f g r m f m h h r f f m f r G G h G G g r h h g g h r g f g h m f g h f r g G G f G h r r m h m h m g g f f r g m g m r f G f g f h r f g f h m G G G h G g f m h m g h f r G f g G G r f 
m g r g f g r G r m r r G r g G G h m f G g G r f h h r m r g G r g G f h g f m f G G g f r m h h g g m G r f h g h m f G G r h f G h h m g G g h f G f G m f G f G f f r g G r g m f g h m r h r g G f 
r h m m g r G f m m r m m f h r r f h r G f h h g m h m f r h G g G m h h f h f h h G m g f r g g f m f f G f m r m r r G g f r G f G g h G r g G m m m r f G m m m G g m G h f g r m g h G f G h r f r 
G r m g G g m G m G r g G g G m G g f f G r G m f G G m f m m g h g f g r m g h r h g m h f g G h m g G h g g g f h m m g f h G f m G r r G G f r g h r f f h G h h G m r f f g m f h f f G h h h g g h 
g G h h f G f h h r f g G m h f m h r f m f m f m G f G G f h m m g G m h r G h m h m m m h f r g r g f G f G r g g r g h f h h G f r G r G m g G r G g r f h r f m h h f r f r h f m h h G G r G m g h 
m h r G r r G m h h g h g m g h g g h m G h g g m h f h m f G g r m h h r m r r m f m r m f r h r h G m m r g f g h f g h r r m r g g G r f m f G G G f f G g r m G G f g g f f f m g g m f g m f h f G 
f r g g G h g r G r G g r G h g f m g r h g g r g m r G f f G r G g m r g m r r h g G g r r r r h f r h g h g m h f r m g r g m G g G f m h r f h G g G g G g f G G m G h G m G h m f G g G f r m G h g 
h h g m g r G G G g h m G f m r g r m h G g G G f g G G m r G m G r f h r r m G r m f g h f m m r f G g h r m m h r f r h g r f m h g g h m r f m G m G G m f r r r r r f r r m G r r h m f g r h h h m 
G f r r r r g f m r f m m m h m f g m r r f m f f f G r m h h f r f r m g m f G G m r h G h g r g m r f f g r m f G r m r h f G h h h g G G g r g r g G g h G h f r m h r m g m m r m G h f f g g G g f 
g f G m G g r G m m f g m G h m h m f r f f m m h G h f h r m r f G m G f h g G G m g r h G g r m h G f h g G h h f m r G m G f m r f G h G r f h g r r m f g h r r G h f g f r m G G r g r r g f m r g 
m G f f m m m r g g h g m g G f h g h f h f r r h f h r m g g f r g f r g r h m g G g h G r g m G G g f f G g r h h m r G h f h G G f G r G h r r r g g h g r f m m h G m r r g r m f G r g h h f G f m 
h G h m g g f h f g r h m G G G g m m G m h r g r g r r f m g r G g r r G r g G m g m h r r h m G m h g h G g f m h h m g h g r r r f G g G r g m h g r m h m r m r h m m G m r g G h h G m f m h h m r 
g G h h g f m g g g r g h g f G G h G m r G g g r m m r G G h m G f g r r h f r r G m m f h h r r m G h f h h r g h h r G G h r r m G G G h r m r G f h h m h f f r g m G h m g r r h h h m m f m g f g 
r m m f g G f h m m r r m f f f r h r h m h m f G f r r f g f h h G G f r h h G h m G m r g G r f r m f h f f g r r r r r f G f h f G m g h m G r r h f g g m m m r h r h h h h r f f m m h h h r f G g 
r G f G g G f m g r m g m r f G m G g g G m G m h m g G h m f G h g m g g m f r g g g h g G m h g g f g g f m G h f h G G r G G G g r G g G r m h m G r f G G h h g r g g r m m G f r f h g G G G m h f 
m r G g f r r f r m g h r r m f g f m r r r G r f f r m f G m G G g f m r h g G f g h f G G r G h r h f h G f G G r m g r f h g h m G h f f m f g g h G g h m h r r f g G m f G g f g f f f r f g m r g 
r G m f r g G f G g g G m G m h r f G r r g G r g m G G m G r f g G g f G r h m G g r G G h h f f h G G g m G f f h f f r f G m r g g m f G G f m h h h f h h g f m g r m g r g g g f G h g h h h h G r 
f r r f g f g r m f G r m h g m m G G g h h m m r m m g m g f h h g f f f m g G m G G m f h G r m G G f f g m r G m G g r r r g f G h g G m G h r r f r g h h h m h f g r m G h g G h h G G G h G r h h 
g r G r m r h g G h G m G r m m r h h g g G h f h f G f g r m m m h r g f m f G f g m G g h g G h m m g h h f h h g f G m r h f f h m g m m r h g h G r f h G f g G r r h h f m g h f G G h G h f G g r 
G g m r G g g h r G m h g h G G m m g r h f G h f g r h f f G h g r G h g f f f g h g f G f m m G h f h g G m h h r m g g g f m f f m r G g g G g m g g g h r h G G h r m r r f r m f g m G h G m m h h 
G g r G g f r g G h m h h g m g G m G G h G m g r g h g f r r g m g h r G m m g G r h g f h r h G G r f G r h h h m g f m r g m m m G m f f g f h g h m g G g m G h h f m h f h m h g r m f g f m f g G 
r h f f r r h m g f f G g f f h G f m h m g f h G g m r G m r m G m g m f G r f m f G f h G m h h f h f m G g m G m m g f f m m h r G G f f G h f g m g f r f G G h f r m f m m g r h r g m G m G r h h 
f g h h h r f m h f g m m m r h G r r f G g G m h f m h f r r h f f m g m r r g g h f f G G G f f r g g f g h g f r f m f g g r r m r h r G m f G g h g g h r m r h g g G g r G f r h G h m r r m h G h 
G h f h m r r f f m m G r g r G m m r G f r r r f h r h g g r g h m g r h m h r g G f G g f f r G G m f m m m m h g r g m m f f f h G h g h g h f G h G f G r r g m m G g g r f h r g G h r f h g r G g 
f g h g G h h h G r m r G h G g g h h g g m f G f f m m m r r G G f r G h G g g r r r f h h g f r g m r g f m h h g m G f f G g f r f f h h G r g h f r m r f G g f r f r h g G r G h m G G g f g g f G 
r g r G f G f r f r m G g m f r h g r h G r G G r h G G h g g h g h r f m f h h G f m h f g f h h m r f r f g f m G h G h f m h G f f f r G g G g m h m m m h h g r m h r G r g g g r G h m G r f f G r 
h f h h f m h G G m f f G f G g f r m G r g G m m f f m h m m f G m h r h G g r f h G g G m r f g G g m r g f f r f G h m g f G G r h G h h m g f f G G f m f G f g m h h m G m G G h g r f h h g G G f 
r g g g m r G m h h g G g r h G h h f h m G f f r r m r f h g G r g m h f m r f m r G f m r h f r m r m G h h f h G f G G m f g g G g g h g r f G m r f h m r G f g G h f r g r r G G m h G f G h r f m 
g G h m h f r G f G r f r G m G r G m f g h h f g f m h g g f G m r f G m f r f h h m G g h r G f r g G f g G m r r G r G r m m G g h r r g r g r f g g G h r G r r r g f r m g h m m r g f r h G h g h 
r m f g G G h h g r G r f m g g r f h r m g h m h m g r f h f r r r g g r m m f f h h G h G G r g m G m G m f g G m r f m m f r G h g g m G f r m f r m r m g g h h h m r h m m g h h g h m r h g g f h 
G m h m h h g h m h h m h m f h g g f r f h f G m m r m f r f g h r m r m G r G r h m G g r G h G m G h G f h G G f f r f r f h h g m h m G m h f m h G h f m r m G m G h r g h r G G m g f f h h g m f 
h f g G m m r h m g g m h m r G m G G h r g h r r r r m m f G f r g m m m g m r h f f h f g g G G h m G h r g m m G m g G G G r G f r f h g g r r f r f f h r h m f r G h m h f m G h h m m G h G m G g 
h g G G g G r h g f g h r g f h h m g m f f g f g m G r r h h r f g g m G h f g g h f G h G m m h f g G r G r G r g h m g h m f h f f h f g m m g r G r r h G m r r f r f G m m g g G h f G m h r G r f 
r r h r g h m f m m m f f f f G G g g m G h r f h h h g G g G h h g m g G g f G g r f G G h G m g r m G G r f g h m g g h m r g f g f m f G m r g r h h g g h h m f f m g r g m g G r f h h g r f m r r 
m G m r f g f f g G m G g m g f h G G G r g G G G m m r m g g m h m G h G r g r f G m r m m m f g h h h m g g m f g g g r h h m r G G g r g f r m f h g G r f f h m h g f m g g h G G g f m g f g f G h 
r m r g G h G g r G h f f G h h G r f r m f g G G g f f m f r m G m m m f h m G r G g G g g m g g m f m h f m f f f h h f g m f m m m m G h r g G m f h G m G G G r r m h h m m g h r G h g h g f g m f 
h g g r h g g h m g h g m r r h h g r h m m f m r r r m g m g g G h r r G g m G m f m r r g h g m G g f f g r g f G r g m h G r h G g h G r g f f G h G g f G g f g m G g r h h g g m G m G m g h f h g 
g G h r g G m h g m g h G f m m g h f m m G G G r G f f g G h r h f G G r G f g m g h h f f G r h G f f m G h G g r r f G f m h h G h m G m r r h g g G f G r g m f m f m m m f g f r m g G r h m r g g 
g G G h f G G g m m m G r m r m g g h h g r G h g g g G h r m G f h h g m h m h G r m m G f G m f G h f m h r g G f r h G g h G f g f h h g m G r r m h r f g h g f m f r h G r f h h f r f G f G g f r 
m f r f r h g r m h g f m r h f m h r h h r r r G f f f h f g h g m r r g h m G m f m G f h f h g r h G m G f m r r m m h m h r h h g f r m m r g g g f r f g r G r h G h h g h h f G m G g G g h h f m 
h g G m f r G g h g G g m g h f h h g m g g g G f G g g g g r r g f G g G g r G h m m f h f f r G h G g f f g h h G f G h m f G r h f f m m G G r h h g f h f h f m r f r m r m m G r f m f G G m g g h 
h m h m G r f r f f m G G h m m r G g h g G m G m m f r f G f f r g r m f G h h m h f r f G G f g g m m h m f m G G f f h r f r r g r m r f h m g g g h r G G G G G f f r h m f g r m m h G g h g f h f 
f r m m h h G h r f r G h r h r h G m f G G f h f f G h h f h r h f f G m h m f h G m f m r g f h r m h G G h g g m r h r h m f m G f f m r r g h g G g m G r G m r m m r f g g m r g f r h h f r h G f 
r m f f G m h r m G m f f r G g G G G m h h f f r G m G g g m G m m r G h m m h m h g G h f h f r m m m g r g G h f G G m m f h g m G r g g r g h f f m G r f r G f r h f r G g g f h m r f r g g m f h 
h g m f m h h r h m r g G f g f r g f r m f r G g G h r m f G g r m G f f G m m h g g m g h g g f m r G h G g g G f f h m G G m f g g h m r g g m m m r f m f m G g f h g f G G r g r G G g f r f g r h 
r G r f m G m h h m G r g g f g G G G g r G h g g h f g m G r r f h G g h g m G m r f h g f f f g g h f h r g m g G m f h h f G h f g f G f r h h g G f m f G h f m f G m m m g G f m f r g f r g m r r 
h r r m g f G g f r f G f h f m G r f f r h G f h h G f r h h f G G f g m f G G h G h m h G f m r f g h G r f m f m r h h g m r G f f g m h G m g f g f f f G f h g h G h r h m r f G m r h m h g G m g 
h G m g r g g r f h h m r G r G g f m r f m G m m g m G f g g G r m f g G f m g G r m f m g h m G r G G G r f g h r h f h m G h h h m f f m G h r m f r G G h m g G m m g G r f h h m G h r f g r r r m 
h g h g m g h h G h f m g g r h h f r G r g G g m f g g G r f g f h g m h m g G m G G f g f g g h r g m G m h g g m g G h f f h m G h h G g G h G G f h f h f g f h f g f r g h g m r m r r m G r G m m 
h G h f G m r r f h g h G G g h r G r r g h g m m G g r G m h G G f f G m m g g m h G h m f f f f f m f G G h r r h m h r g r f f f m g g f r r h r G f m r m m m h g G G f m G m f m f r f g h G g m G 
f h r g G f r g h G r r G m r m h m f G f m f r G r m f h h h m f g G f f m f f m f r G r G m G G r r r m m f h r h m h g m m m h g r r f r r m G h h m m g f r G f m r g h g G h r r m g f m f r g g h 
h G f r h G f r h r f h h f g g G h G m g h h h m f m G G g f f r G m r G G f m h r G r r g G m r r h m f m h h f m h f G r h h f f g h G r r f g h m g h g r G m m g G r r f G f h m r r f m f g h m h 
G g f r h G m m f f f g m h G h G g G h h h m h h r f r h G f r m m f f f r h f m f g f G G f G h r h r f r r G r g r G h m G h g h f f m g g h m g G m r h m h f r r g f G h g G h m r r m m f h m m g 
f r G m m r h G r m m h f g g G r h m m G r r G r G h f g r h f g h r G G h f m g h r h G m m g h m g G m G m h r r h f g r h f f r f r g g G G g G G g g m m G G h m f G g r m g h f G G f f f f f f g 
g m h h r G h g f G r g m r G m r g f h m G m g f g h m h g g m g G G g G r g g h G f g G h r G G h G f G f g m f m r m g g m f m g G f m G r m h f g h g G f h f m r g r f f h G f g g f h r m r f g g 
r m r r r r G m m G f r g G r G G m g h h m f f f f G m G r f h f h g h h m G G f G f G g m r h m G f f m g r r h m r f G r G m h f r r G m m m r m g m h f m h g h h f g G m m m h m r h G m f g G m f 
r r g r G r m G g f r g h f h r r r G h r f h g G f g G f G m g g f f f f G f g h m g G g h g h h f h G m G g f f G r g g h r G G h r r f g g G G G f r g G r g G h m g m G g r g m G h r G f G g h h G 
g h G g h m G g m f g h r g h r r r G g f m h r r g f r h h m r h G r f m m m r f G f m m m G G r f g m f G f g r h f g r r f h f h f m G r f G m g f m g f m G m g G m m m G r r r h h r h G f m h m G 
G f g g g g m f g r r h g h m m m G h m m G g g f g r f G f r h g f G f g r r g h f G f G f g h f r g f G r r h r h h f r G m f g f m G g r r g m m r f r g G f h G f h G m r g h g f G h r g g f g G f 
m G m f m g m f f h h f g r h G h g h g r m f h m m G h h g h m G m h f m f h r m h g f r G m f m G g m f h G G h h r g g r m g r f f g r f g r h g g m g g h r G g G m h r h r m g r h h f f G G g f h 
g f r m G G m h g h r h f h f g g h g g h m f m G h m m f G r f r g G m r g h f m f h h G r g m g h G g r f g r G g h g m h r m m g g m f h g h g f r f g g m m f G g r G g g r g m r r f G m G h f G g 
h h r r r m m f g h G h G r g m m r f m r h G m m f h g m g h h G m G G f r f f h g r G G h m h r r h r G f f g G G G g m f r G g r h g m h g m g G h g g m m g f m g f m r m g g f g h m G m g h g G r 
m g g f f f G g m g G m f g m g r G m f G h g G G G g m G r h m g r r g h m f g g m r m m G r m m g G f m r r h r h g h G m h h r h m m m G G G f h G r h g r h g G m G f f g f m G G m h h G f m f h f 
0 0
99 99
